1111111111111111111111111111111111
1E0000000000000C00000C000000000001
101K0101001000001010K1000000010101
1010010010101010001001000000010101
100000000C00C0K00000000000000000P1
1111111111111111111111111111111111