1111111111111
1001C100000C1
10K00000110K1
10P011E0C0001
1111111111111