11111111111111111111
1E000000000000000C01
101000C1001000001011
10100101001000001011
1010010100100C001C11
101001K1001000001011
101001010010K0001011
10100101001000001C11
10100100101010100011
1P00K0000C00C0000001
11111111111111111111